teams 2
width 16
height 16

map
########......####......########
##..............##............##
##..1e..........##........0s..##
##..............##............##
..........##....##..............
..........##....########........
..........##....................
############..................##
##..................############
....................##..........
........########....##..........
..............##....##..........
##............##..............##
##..0n........##..........1w..##
##............##..............##
########......####......########
end
